MoNETA
AI - ИИ
To reason - понимать
Relatively - относитлеьно
According to - в отношении
Witless - глупый
To distinguish from - отличатся от
To perceive - воспринимать
To suspect - полагать
Adherence - 
Instantaneous - мгновернный
Resemble, resemblance - походить на
To coax - уговаривать
Accurately - точно
To fill the bill - удовлетворять требованиям
To bankroll - давать деньги
To yield - выдавать
Irreplaceable - незаменимый
To confine - ограничивать
Niche - ниша
To astound - поражать
To stand still - стоять на месте
To stray out - отклонятся
Decent - приличный
Vehicle - транспортное средство
Objective - цель

To negotiate - отрицать
Spur-of-the-moment - спонтанно
Ambiguity - двусмысленно
Abysmally - плачевно
To defeat - побеждать, поражать кого либо
Predecessor - предешственник
Brute-force strategy - грубой силой
Draw - рисовать
To launch - запускать
Ante - ставка
Desolate - безжизенный
Sobering results - отревляющие результат
Utterly - абсолютно
Amok - вне себя
To disengage - развязать
Simultaneously - одновременно
To replicate - повсторять
Outcome - результат
Conventional - обычный
To augment - увеличивать
To enchant - очаровывать
To attempt - пробовать
To gobble up - сожрать
Immediately - немедленно
Access - доступ
Sequence - последовательность

Stupendous - громадный
Shortcuts - короткий путь
To evaluate - выполнять
Instead of - вместо
Indeed - действительно
Nonvolatile - энергонезависимый
Upshot - результат
To decay - распадать
Lattice - решетка
Directly - непосредственно
Magnitude - магнитуда
Drastically - радикально
Consumption - потребление
Conceit - самомнение
To suck up - подлизываться
To carry out, to perform - предствлять
Explicitly - явно
Throughout - везде
To acquire - приобретать
Sophisticated - сложный
Maze - пазл
Consciousness - сознание
Relentless - неустанный
To shrink (shrank, shrunk) - уменьшать
Unreliable - ненадежный
To rely on - полагаться
